SC	class1
SC HC	class1hc
SC HCO	class1hco
TT	class2
TT HC	class2hc
TT HCO	class2hco
PM	class3
PM HC	class3hc
PM HCO	class3hco
S	class4
S HC	class4hc
S HCO	class4hco
DB	class5
DB HC	class5hc
DB HCO	class5hco
AT	class6
AT HC	class6hc
AT HCO	class6hco
SC	asc
HC	hasc
Teet	nobeer
Booze	nofood
Oxy	oxy
Artist	palette
Delicious Salad	saladtat
Martini	martini
Demon Tattoo	demontat
Best Game Ever!!!	margaraxe
Sneaky Pete XXIX	sspdtat1
Loathing Legion	lltat
Alice's Army	foilheart
Sneaky Pete XXIX 2	sspdpook2
Sneaky Pete XXIX 3	sspdfipp3
AWOL	aol
Sneaky Pete XXIX 4	sspd4plunk
Corrupted Data	datatat
Sneaky Pete XXIX 5	sspdfi5if
AoB	class11
AoB HC	class11hc
FDKOL tattoo	fdkoltat
Zombie Slayer	class12
Zombie Slayer HC	class12hc
AoJ	class14
AoJ HC	class14hc
Mark of the Bugbear	dv_tat1
Mark of the Werewolf	dv_tat2
Mark of the Zombie	dv_tat3
Mark of the Ghost	dv_tat4
Mark of the Vampire	dv_tat5
Mark of the Skeleton	dv_tat6
Dreadsylvania 1000FK Tattoo	dvinntat
AoSP	class15
AoSP HC	class15hc
Merc Core challenge coin	merctat
Spring Break Beach tattoo coupon	sbreaktat
Ed	class17
Ed HC	class17hc
Dinsey tattoo kit	dinseytat
DEBBIE Tattoo	debbietat
Wal-Mart Tattoo	walmarttat
LT&T Tattoo	ltttat
Batfellow Tattoo	batmantat
Cow Puncher	class18
Cow Puncher HC	class18hc
Beanslinger	class19
Beanslinger HC	class19hc
Snake Oiler	class20
Snake Oiler HC	class20hc
Airplane tattoo	planetat
Fluffy Bunny	sourcetat
Detective Tattoo	detbadge
Proton Tattoo	protontat
Twitch Television Tattoo	twitchtat
Eternal Knot Tattoo	eternaltat
I Love Gingerbread City	gingercitytat
Gelatinous Noob	class23
Gelatinous Noob HC	class23hc
Spacegate Initiative	sgtat
New-You Tattoo	newyou
KGB Tattoo	kgbtat
FantasyRealm Tattoo	frtat
Gattoo	gtat
Bastille Battalion tattoo kit	bbatttat
Party Tattoo&trade; gift certificate	partytat
Hobo	hobotat
